Boston Celtics: Lucky the Leprechaun
Charlotte Hornets: Hugo the Hornet
Chicago Bulls: Benny the Bull
Memphis Grizzlies: Grizz the Bear
Minnesota Timberwolves: Crunch the Wolf
Milwaukee Bucks: Bango the Buck
New Orleans Pelicans: Pierre the Pelican
Orlando Magic: Stuff the Magic Dragon
Toronto Raptors: The Raptor
Washington Wizards: G-wiz the Wizard
Denver Nuggets: Rocky the Mountain Lion
Houston Rockets: Clutch the Bear (Mouse)
Los Angeles Clippers: Chuck the Condor
Philadelphia 76ers: Franklin the Dog
Phoenix Suns: The Gorilla
Portland Trail Blazers: Blaze the Trail Cat
Atlanta Hawks: Harry the Hawk and Skyhawk
Cleveland Cavaliers: Sir CC and Moondog
Dallas Mavericks: Champ and Mavs Man
Miami Heat: Burnie the (???)
Sacramento Kings: Slamson
Detroit Pistons: Hooper the Horse
Indiana Pacers: Boomer the Panther
Utah Jazz: Jazz Bear
Oklahoma City Thunder: Rumble the Bison
Los Angeles Lakers: Jack
San Antonio Spurs: The Coyote
Brooklyn Nets: No Mascot
Golden State Warriors: No Mascot
New York Knicks: No Mascot